#####
#   #####
# # $ $ #
# ..#   #
## . $ ##
 #  # @#
 #######
