  #### 
###  ####
#  $    #
# # ### #
# # *@# #
#   .## #
####    #
   ######
